s000ww000000000
00www00ww00ww00
0ww000ww00www00
0000ww000wwww0w
ww00000ww00000w
w000ww0ww0ww000
w000ww0000ww0ww
w000ww00wwww0w0
w000000wwww00ww
0000000ww00www0
00wwwwwww000000
000000000www0w0
ww000www0000000
00000wwwwww00ww
www000000www00g